111111111111111111111
100000000000000000001
100000000000000000001
1000C000C000C00000001
10000000P000000000001
100001000000C00000001
111000C00000000000001
11000000C0000E0000001
111111111111111111111